┌───┬┬┬┬─┐
│   │││v │
│   ││v  │
│   │v   │
│   v    │
│        │
│        │
│@      █│
│        │
│        │
│   ^    │
│   │^   │
│   ││^  │
│   │││^ │
└───┴┴┴┴─┘
Nonononono
